1111111111111111111111111111111111111111111111111111
1P00000000001000000000000000000000000100000010000111
1000000C000010000000C0000000100000000100000010011111
1000000000001000000000000000100000000100111110001011
1000000000001000000000000000100000000100100000001111
1000000000001111111000000000100000000000000000000011
1000000000000000001000000000100000000000000000000001
1000000000000000001000000000000000000000000000000001
1000000100000000001000000000000000000111111100000001
1000000000000000000000000000000000000000000000000001
1000000000000000000000000000000000000000000000000001
1000000000000000000000111111100000000000000000000001
1000000000000000000000000000100000000000000000000001
10000000000000000000000111101000000000000C0000000001
1000000000000000000000010010100000000000000000000001
1000000011111000000000010010111111111111111111000001
1000000010101000000000010010000000000100000001000001
1000000011111000000000010010000000000C10000001000001
1000000000000000000000010011111111111111111101000001
1000000100000000000000000000000000000000000101000001
1100001E10000000000000000000000000000000000101000001
1110000100000000000000000000000000000000000101000001
1111100000000000000000000000000000000000000100000001
1111111111111111111111111111111111111111111111111111