11111111111111
1PC00000000011
1CC0000C000011
100000000000E1
11111111111111