11111111111111
1P000000000011
10000000000011
1000CCCCCCCCE1
11111111111111