1111111111111111111111111111111111111111111111111
1000000000000000000000000000000000000000000000001
1000P0000000000000000000C000000000000000000000001
100000000000000000000000CC00000000000000000000001
1000000000000000000000000000000000000000000000001
1000000000000000000000000000000000000000000000001
10000000000000010000000000000000000C0000000000001
1011110000000001C100000000C0000000000000000000001
1000E10000000000100000000000000000000000000000001
1111111111111111111111111111111111111111111111111