11111111111111111111111111111111111111111
1P000000000010000000000000000000000001001
1000000C000010000000C00000001000000001001
10000000000010000000000000001000000001001
10000000000010000000000000001000000001001
10000000000011011110000000001000000000001
10000000000000000010000000001000000000001
1000E000000000000010000000000000000000001
11111111111111111111111111111111111111111