1111111111111111111111111111111111111111111111111111
1000100000001000000000000000000000000100000010000111
1001P1000000100000000000000010000000010000C010011111
1000000000001000000000C00000100000000100111110001011
100000000C001000000000000000100000000100100000001111
1000000000001111111000000000100000000000000000000011
1000000000000000001000000000100000000000000000000001
1000000000000000001000000000000000000000000000000001
1000000100000000001000000000000000000111111100000001
1000000000000000000000000000000000000000000000000001
1000000000000000000000000000000000000000000000000001
1000000000000000000000111111100000000000000000000001
10000000000000000000000000001000000000000C0000000001
1000000000000000000000011110100000000000000000000001
1000000000000000000000010010100000000000000000000001
1000000011111000000000010010111111111111111111000001
1000000010101000000000010010000000000100000001000001
1000000011111000000000010010000000000C10000001000001
1000000000000000000000010011111111111111111101000001
1000000100000000000000000000000000000000000101000001
1100001E10000000000000000000000000000000000101000001
1110000000000000000000000000000000000000000101000001
11111000000000000000000000000000000000000001C0000001
1111111111111111111111111111111111111111111111111111