111111111111111111
1P0000000000111CC1
100000000000111011
1000CCCCCCCCE11011
111011111111111011
111000000000000011
111111111111111111