1111111111111111111111111111111111111111111111111111
100010000000100000000000000C000000000100000010000111
1001P10000001000000000011111100000010000C01000011111
100010000000100001111001000C100000000100111111001011
100000000C001000000010010000100000000100100000101111
10000000000011111110100100001000000000000000010C0011
1000000000000000001010010000100000000000000010000001
100000000000111000101CC10000000000000000000100000001
1000000111000111110011100000000000011111110000000001
1000000000100000000000000000000000000000010000000001
1000000000011000000000000000000000011111C10000000001
1000000000000111111000111111100000000010110000000001
1000000000000000C00000000000100111111110C10000000001
1000000000000111111000011110101100000010011111111001
1000000000000000000000010010100000000000000000011001
1000000011111000000000010010111111111111111111000001
1000000010101000000000010010000000000100000001000001
1000000011111000000000010010000000000C10000001000001
1000000000000000000000010011111111111111111101110001
1000000100000000000000000000000000000000000101C10001
1100001E10000000011111001111111111100000000101010001
1110000000000000010000000000000000111111111101010001
111110000000000001C00000000000000000000C0001C0000001
1111111111111111111111111111111111111111111111111111