111111111111111111
1P0000000000111111
100000000000111111
1000CCCCCCCCE11111
111111111111111111
111111111111111111